%%%%%%%%%%%%%%%%%%%%%%%%%%%%%%%%%%%%
%.................................P%
%.%%%%%%%%%%%%%%%%%%% %%% %%%%%%%% %
%.%%   %   %      %%% %%%   %%     %
%.%% % % % %.%%%% %%%%%%%%% %% %%%%%
%.%% % % % %.% .. %%     %% %%     %
%.%%.%.%.% %.% %%%%  %%%    %%%%%% %
% %  % % %   %    %% %%%%%%%%      %
% %% % % %%%%%%%% %%        %% %%%%%
% %% %   %%       %%%%%%%%% %%     %
%    %%%%%% %%%%%%%      %% %%%%%% %
%%%%%%      %       %%%% %% %      %
%      %%%%%% %%%%% %    %% %% %%%%%
% %%%%%%      %F      %%%%% %%     %
%.       %%%%%% %%%%%%%%%%% %%  %% %
%%%%%%%%%%                  %%%%%% %
%  .       %%%%%%%%%%%%%%%% ...... %
%%%%%%%%%%%%%%%%%%%%%%%%%%%%%%%%%%%%